11111111
1E0000P1
100XC011
11111111